#Xa##bbb
XaXabXbX
aXa##bbb
#a######
#c######
cXc##ddd
XcXcdXdX
#Xc##ddd
