fX6Xf###
#fff####
#e######
eXe#####
X5Xe#ggg
eXe#gX7X
#e###ggg
########