#Xh#####
X8Xhjjj#
hXhjX0Xj
#hi#jjj#
#iXi####
iX9Xi###
#iXi####
##i#####