####h###
###hXh##
##hX8Xh#
###hXhi#
jjj##iXi
X0XjiX9X
jjj##iXi
######i#